.......................................
.......................................
.......................................
.......................................
...............гГ......................
..............тнН......................
..s..@.....клбп..ПБhЛК.................
uuuuuuuuuuuuuuuuuuuuuuuuuuuuuuuuuuuuuuu