##########################################################################################################################################
##########################################################################################################################################
##########################################################################################################################################
##########################################################################################################################################
##########################################################################################################################################
##########################################################################################################################################
######2ddddddddddddddddddddddddddddddddddddddddddddddddddddddddddddddddddddddddddddddddddddddddddddddddddddddddddddddddddddddddddddddd32dddddddddddddddddddddddddddddddddddddddddddddddddddddddddddddddddddddddddddddddddddd3######
######r...............................................................................................................................lr....................................................................................l######
######r...............................................s...............................................................................lr....................................................................................l######
######r...........................................<======>............................................................................lr....................................................................................l######
######r.....................................<>.................................<===============>......................................lr....................................................................................l######
######r...............................................................................................................................lr....................................................................................l######
######r........................................<>.................................................<=>.................................LD....................................................................................l######
######r.............................................<>......................................................................................................................................................................l######
######r.................................................................................................<=>.................................................................................................................l######
######r...............................UR...<>....<>...................................................................................UR....................................................................................l######
######r.............................Uu4r....................................................................<=>.......................lr....................................................................................l######
######r.........................Uuuu4##r.....................<====>...............................................<=>...........<=>...lr....................................................................................l######
######r.@...c......f.........Uuu4######r........c..e..........e.......................................................................lr....................................................................................l######
######1uuuuuuuuuuuuuuuuuuuuuu4#########1uuuuuuuuuuuuuuuuuuuuuuuuuuuuuR...Uuuuuuuuuuuuuuuuuuuuuuuuuuuuuuuuuuuuuuuuuuuuuuuuuuuuuuuuuuuuu41uuuuuuuuuuuuuuuuuuuuuuuuuuuuuuuuuuuuuuuuuuuuuuuuuuuuuuuuuuuuuuuuuuuuuuuuuuuuuuuuuuuu4######
#####################################################################r...l################################################################
#####################################################################r...l################################################################
#####################################################################r...l################################################################
#####################################################################r...l################################################################
#####################################################################1uuu4################################################################